w                              w
w                              w
w e                            w
www  wwwww                     w
w         w      n             w
w          w       n           w
w           w        n         w
w            w         n       w
w             w                w
w             wwwwwwwwwwwwww   w
w                             ww
w                   n        w w
w                   www     w  w
w                        w w   w
w                       ww     w
w s       n     n     wwww     w
w  w      n    www             w
wwwwwww wwwwwwwwwwww  wwwwww  ww
