w                              w
w                              w
we                             w
w wwwwwwwwwwwwww               w
w                              w
w                   wwwwwwwwwwww
w                ww            w
wwwwwwww         ww            w
w                              w
wwwwww           w        wwwwww
w           w   ww             w
w           w         wwwwwwwwww
wwwwwwwwwwwww                  w
w                 ww           w
w                w w           w
w s            w w www         w
wwwwwwwwwwwwwwwwwwwwwwwwwwwwwwww
wwwwwwwwwwwwwwwwwwwwwwwwwwwwwwww
