w                              w
w                              w
w                             ew
wwwwwwwww  wwww    wwwwwwwwwwwww
w        w                     w
w         ww w ww w            w
w                  w           w
w                   www        w
w                        w     w
wwwwww                wwwwwwwwww
wwwwwwwww  www   w            ww
w           ww       wwwwwwwwwww
wwwwwwwwwwwwwww    w   w  w    w
w                 ww   w  w    w
w                www   w  w    w
w             wwwwww   w  w    w
w w s      wwwwwwwww           w
wwwwwwwwwwwwwwwwwwwwwwwwwwwwwwww
