w                                   w
w                                   w
w                                   w
w                                   w
w                                   w
w                                   w
w                                   w
w                        wwww       w
w                                   w 
w        wwwww                      w
w                                   w
w                     w  t          w
w         www            t          w
w                        t          w
w                                   w
w s            w             	    w
w  w  n   w   www            wew	w
wwwwwwwwwwwwwwwww wwwwwwwwww wwwwwwww
