w                                   w
w                                   w
w                                   w
w                                   w
w                                   w
w                                   w
w                                   w
w                        wwww       w
w                                   w 
w        wwwww                      w
w                                   w
w                     w             w
w         www                       w
w                                   w
w                                   w
w s            w             	e   w
w  w     w   www   n         w w	w
wwwwwwwwwwwwwwwww wwwwwwwwww wwwwwwww
